+--+--+--+--+--+--+--+--+--+--+--+--+--+--+-S+--+--+--+--+--+
|              |           |              |  |  |     |     |
+  +--+--+  +  +  +--+--+  +--+  +  +  +--+  +  +  +  +  +  +
|  |     |  |     |     |     |  |  |  |     |  |  |     |  |
+  +  +  +  +--+  +  +  +--+  +--+  +--+  +--+  +  +--+--+  +
|     |  |  |     |  |  |           |     |     |  |        |
+--+--+  +  +  +--+  +  +--+--+  +--+  +--+--+  +  +  +--+  +
|        |  |     |  |  |     |  |     |     |     |     |  |
+--+--+  +  +  +--+  +  +  +  +--+  +--+  +  +  +--+--+  +--+
|     |  |  |  |     |     |        |     |  |  |     |     |
+  +  +--+  +--+  +--+--+--+--+--+--+--+  +  +--+  +  +--+  +
|  |        |     |     |                 |        |     |  |
+  +--+--+  +  +--+  +  +--+  +--+--+  +--+--+--+--+--+  +  +
|  |        |  |     |     |        |     |  |        |     |
+  +  +--+--+  +  +  +--+  +--+--+--+--+  +  +  +  +--+--+  +
|  |  |  |     |  |     |  |        |     |     |        |  |
+  +  +  +  +--+--+--+  +  +  +--+  +  +--+--+--+--+  +  +  +
|  |     |              |  |  |     |        |        |  |  |
+  +--+--+--+--+--+--+--+  +  +  +--+--+--+  +  +--+--+--+  +
|  |              |     |     |     |        |     |        |
+  +  +--+--+--+  +  +  +--+--+--+  +  +--+--+  +  +  +--+--+
|     |        |  |  |     |     |     |     |  |  |  |     |
+  +--+  +--+  +  +  +  +  +--+  +--+--+  +  +--+  +  +--+  +
|  |  |     |  |  |  |  |        |        |     |  |     |  |
+  +  +--+  +  +  +  +  +--+--+  +--+--+  +--+  +  +--+  +  +
|     |     |     |  |        |  |        |  |     |  |     |
+--+  +  +--+--+--+  +--+--+  +  +  +--+--+  +--+  +  +--+  +
|  |  |     |        |  |     |     |           |  |  |     |
+  +  +--+  +  +--+--+  +  +--+--+--+  +  +--+--+  +  +  +--+
|  |  |  |     |        |     |     |  |  |     |  |  |  |  |
+  +  +  +--+--+--+--+  +--+  +  +--+  +  +  +  +  +  +  +  +
|  |  |              |     |  |        |     |        |  |  |
+  +  +--+--+--+  +  +  +  +  +  +--+--+--+--+--+--+--+  +  +
|  |              |     |  |  |  |        |  |        |     |
+  +--+--+--+--+--+  +--+--+  +  +--+  +  +  +  +--+  +--+  +
|        |     |     |        |        |  |  |  |  |        |
+  +--+--+  +  +  +--+  +--+--+--+--+--+  +  +  +  +--+--+--+
|           |     |  |        |        |     |     |        |
+  +--+--+--+--+--+  +--+--+  +  +--+  +--+--+--+  +--+  +  +
|                          |        |                    |  |
+--+--+--+--+E-+--+--+--+--+--+--+--+--+--+--+--+--+--+--+--+
