+--+--+--+--+--+--+--+-S+--+--+--+--+--+--+--+--+--+--+--+--+--+--+--+--+--+--+--+--+--+--+
|                    |  |              |           |        |              |  |           |
+  +--+--+--+  +  +--+  +--+  +  +--+--+  +  +--+  +--+  +--+  +--+--+  +  +  +  +--+--+  +
|     |     |  |  |     |     |  |        |  |  |     |              |  |     |  |     |  |
+--+--+  +  +  +  +  +--+  +--+  +  +--+--+  +  +--+  +--+--+  +--+--+  +--+--+  +  +  +  +
|     |  |     |  |     |     |  |  |        |     |        |  |     |              |  |  |
+  +  +  +--+--+  +--+  +--+  +  +  +  +--+--+  +--+--+--+  +--+  +  +--+  +--+--+--+--+  +
|  |     |     |  |  |     |  |  |  |     |     |        |     |  |     |  |              |
+  +--+--+--+  +  +  +--+  +  +--+  +--+  +  +--+  +  +--+--+  +  +--+  +--+  +--+--+--+  +
|  |           |     |  |  |     |     |  |  |     |        |     |  |        |  |        |
+  +--+  +  +--+--+  +  +  +--+  +  +--+  +  +  +--+--+  +  +--+--+  +--+--+--+  +  +--+--+
|     |  |              |     |  |  |     |        |     |     |           |     |     |  |
+--+  +  +--+--+--+--+--+--+  +  +  +  +--+  +--+--+  +--+--+  +--+  +--+--+  +  +--+  +  +
|     |  |  |     |     |     |  |  |  |     |     |        |        |        |     |     |
+  +--+  +  +  +  +  +  +  +--+  +  +  +  +--+  +  +--+--+  +  +--+--+  +--+--+  +  +--+  +
|     |     |  |     |  |  |        |  |  |     |     |     |  |        |     |  |     |  |
+--+  +--+--+  +--+--+  +  +--+--+  +  +--+  +--+--+  +  +--+--+  +--+--+  +--+  +--+--+  +
|     |        |        |  |     |  |     |  |        |           |     |     |           |
+  +--+  +--+--+  +--+  +  +  +  +--+  +  +  +  +--+--+  +--+--+--+  +--+  +  +--+--+--+--+
|              |     |  |     |     |  |  |  |        |        |     |     |              |
+  +--+--+--+--+--+  +  +--+--+--+  +  +  +  +--+--+  +--+--+  +  +--+  +--+--+--+  +--+--+
|  |        |        |           |  |  |  |        |  |     |  |     |  |  |     |        |
+  +  +--+  +  +--+--+--+--+--+  +  +  +  +--+--+  +  +  +  +  +--+  +  +  +  +  +  +--+  +
|  |  |  |  |           |        |  |  |           |  |  |     |     |     |  |  |     |  |
+  +  +  +  +  +--+--+  +--+--+--+  +  +--+--+  +--+  +  +--+--+  +--+--+  +  +  +--+--+  +
|  |  |     |     |  |     |        |  |     |  |     |  |        |        |  |           |
+--+  +  +--+--+  +  +--+  +  +--+--+--+  +  +--+  +--+  +--+  +  +  +--+--+  +--+--+--+  +
|     |  |     |     |     |  |           |     |     |     |  |  |  |        |        |  |
+  +--+  +  +  +--+  +  +  +  +  +--+--+--+--+  +  +  +--+  +  +--+  +  +--+--+  +--+  +  +
|  |  |  |  |        |  |  |     |     |        |  |  |  |  |        |  |     |     |     |
+  +  +  +--+--+--+--+  +  +--+--+  +  +  +--+--+--+  +  +  +  +--+--+  +  +  +--+  +--+--+
|  |        |           |        |  |     |     |     |     |  |     |     |  |     |     |
+  +--+--+  +  +--+--+  +--+--+  +  +--+--+  +  +  +--+  +--+  +  +--+--+--+  +  +--+--+  +
|        |     |  |     |     |  |     |     |  |     |  |  |     |           |  |        |
+  +--+  +--+--+  +  +--+  +  +--+--+  +  +  +  +--+  +  +  +--+  +  +--+--+--+  +--+  +  +
|  |  |  |              |  |  |        |  |  |        |  |        |  |        |        |  |
+  +  +  +--+--+--+--+--+  +  +  +--+--+--+  +--+--+--+  +  +--+--+  +  +--+--+--+--+--+  +
|     |  |                 |     |        |  |        |  |  |     |  |           |        |
+--+  +  +  +--+--+--+--+--+--+--+--+  +  +  +  +  +--+  +  +  +  +  +  +--+--+  +  +--+--+
|     |  |        |                    |     |  |  |     |  |  |     |        |     |     |
+--+--+  +--+--+  +--+  +--+--+  +--+--+--+--+  +  +  +--+--+  +--+--+--+--+  +--+--+--+  +
|              |     |        |  |           |  |  |        |  |     |  |     |           |
+  +--+  +--+--+--+  +--+--+--+  +--+  +--+--+  +  +--+--+  +  +  +  +  +  +--+  +--+--+  +
|  |     |     |     |           |     |        |           |     |  |  |        |  |     |
+  +--+--+  +  +  +--+  +--+--+--+  +--+  +--+--+--+--+--+--+  +--+  +  +--+--+--+  +  +--+
|           |  |  |     |        |  |     |           |     |  |     |        |     |     |
+  +--+--+--+  +  +--+  +  +--+  +  +  +--+--+--+  +  +  +--+  +  +--+--+  +  +--+  +--+  +
|  |        |  |     |  |     |  |  |        |     |  |        |  |        |     |     |  |
+  +  +--+--+  +--+  +  +--+  +  +  +--+--+  +  +--+  +--+--+  +  +--+  +--+--+  +  +--+  +
|  |        |     |  |        |  |     |     |  |           |  |  |     |     |     |     |
+  +  +--+  +  +--+  +--+--+--+  +  +  +  +--+  +--+--+--+  +--+  +  +--+  +  +--+--+  +--+
|  |     |  |     |     |        |  |  |  |  |        |           |        |  |        |  |
+  +--+--+  +--+  +--+  +  +--+--+  +--+  +  +  +--+  +--+--+--+--+  +--+--+  +  +--+--+  +
|           |  |  |     |     |           |  |  |  |     |        |        |     |     |  |
+--+--+--+  +  +  +  +--+--+  +  +--+--+--+  +  +  +--+  +--+  +  +--+--+  +--+--+  +  +  +
|        |  |  |     |        |  |                    |     |  |        |  |        |     |
+  +--+--+  +  +--+--+--+  +--+  +  +--+--+--+--+--+--+--+  +  +--+--+--+  +  +--+  +--+  +
|  |     |  |              |  |  |  |              |        |        |     |     |  |  |  |
+  +  +  +  +--+--+--+  +--+  +  +--+  +--+--+--+  +  +--+--+  +--+  +  +--+--+--+  +  +  +
|     |                 |              |              |           |                 |     |
+--+--+--+--+--+--+--+--+--+--+--+--+--+E-+--+--+--+--+--+--+--+--+--+--+--+--+--+--+--+--+
