+--+--+--+--+--+--+--+--+--+--+--+--+--+--+--+--+--+--+--+--+--+--+--+--+--+
S    |        |        |     |        |        |              |           |
+--+  +  +--+  +  +--+  +  +  +  +--+  +  +--+--+  +--+--+--+  +  +--+  +  +
|  |  |     |  |  |  |     |     |     |        |  |           |     |  |  |
+  +  +--+  +  +  +  +--+--+--+--+  +--+--+--+  +  +  +--+--+--+--+  +  +  +
|     |     |  |  |                    |  |     |  |     |           |  |  |
+  +--+  +--+  +  +--+--+--+--+--+  +  +  +  +--+  +--+  +--+--+  +--+  +--+
|  |     |  |     |     |  |        |           |  |        |        |     |
+  +  +--+  +  +--+  +  +  +  +--+--+--+--+--+  +  +  +--+  +--+--+--+--+  +
|        |     |  |  |  |  |  |        |     |  |  |     |              |  |
+--+--+  +--+--+  +  +  +  +  +  +--+--+  +  +  +--+--+  +--+--+--+--+  +  +
|     |           |  |     |  |     |     |     |        |  |        |  |  |
+--+  +--+--+--+--+  +--+--+  +--+  +  +--+--+--+  +--+--+  +  +--+  +  +  +
|     |           |              |  |  |        |  |     |  |     |     |  |
+  +  +  +  +--+  +--+--+--+  +  +  +  +  +--+  +  +--+  +  +  +  +--+--+  +
|  |  |  |  |     |           |  |  |     |     |  |     |     |     |     |
+  +--+  +--+  +--+--+--+--+--+  +  +  +--+  +--+  +  +--+--+--+--+  +  +  +
|        |     |     |        |  |     |     |     |        |           |  |
+--+--+  +  +--+  +  +  +  +  +--+--+--+  +--+  +--+  +--+--+  +--+  +--+  +
|     |  |     |  |     |  |  |     |        |     |           |     |     |
+  +  +--+--+  +--+--+--+--+  +  +  +  +--+  +--+  +--+--+--+--+  +--+  +--+
|  |  |     |              |  |  |     |     |     |        |     |  |     |
+  +--+  +  +  +--+--+--+  +  +  +--+--+  +--+  +--+  +  +--+  +  +  +--+  +
|        |  |     |        |        |     |     |     |        |  |     |  |
+--+--+--+  +--+  +  +--+  +  +--+--+  +--+  +--+  +--+--+--+--+--+--+  +  +
|     |        |  |     |  |  |                 |  |        |     |  |     |
+--+  +  +  +  +  +--+  +  +  +  +--+--+--+--+--+  +--+--+  +  +  +  +--+--+
|     |  |  |  |     |  |  |  |  |     |     |     |        |  |        |  |
+  +--+--+  +  +--+  +  +--+  +  +  +  +  +  +  +--+  +--+--+  +--+  +  +  +
|  |  |     |        |        |  |  |  |  |  |  |  |  |        |     |     |
+  +  +  +--+--+--+--+--+--+--+--+  +  +  +  +  +  +  +  +--+--+  +  +--+  +
|     |     |  |              |     |  |  |  |  |  |           |  |     |  |
+  +--+--+  +  +  +--+--+  +--+  +--+  +  +  +  +  +--+  +  +  +  +--+--+  +
|           |  |        |        |        |  |     |     |  |  |        |  |
+--+--+--+--+  +--+--+  +--+--+--+--+--+--+--+  +--+  +--+--+  +--+--+  +--+
|     |  |     |           |     |        |     |     |     |     |  |     |
+  +  +  +  +  +  +  +  +  +--+  +  +--+  +  +--+--+--+--+  +--+  +  +--+  +
|  |  |     |     |  |  |  |     |     |     |     |        |     |     |  |
+  +  +  +--+--+--+--+  +  +  +--+--+  +--+--+  +  +  +--+--+--+  +  +  +  +
|  |  |  |        |     |        |     |        |     |           |  |     |
+  +--+  +  +--+  +  +  +--+  +  +  +--+  +--+--+  +--+  +  +--+  +  +--+--+
|        |  |  |  |  |     |  |  |  |     |     |  |     |     |  |  |     |
+--+--+--+  +  +  +--+--+--+  +--+  +  +--+  +  +  +  +--+--+--+  +  +--+  +
|              |        |     |     |        |  |  |  |        |  |        |
+  +--+--+  +--+--+--+  +  +--+  +--+--+--+--+  +  +  +--+--+  +  +--+  +--+
|  |     |  |  |     |  |  |     |        |     |  |  |     |  |  |     |  |
+  +--+  +  +  +  +  +  +  +  +--+  +  +--+  +--+  +  +  +  +  +  +  +  +  +
|        |     |  |     |        |  |  |     |     |     |  |     |  |  |  |
+  +--+--+--+--+  +--+--+--+  +  +  +  +  +--+  +--+--+--+  +--+--+  +  +  +
|              |              |     |        |              |        |     E
+--+--+--+--+--+--+--+--+--+--+--+--+--+--+--+--+--+--+--+--+--+--+--+--+--+
