+--+--+--+--+--+--+--+--+--+--+--+--+--+-S+--+--+--+--+--+--+--+--+--+--+--+--+--+--+--+--+
|           |                    |     |  |                       |        |              |
+  +--+  +--+  +--+--+--+  +--+  +  +  +  +  +--+--+  +--+--+--+  +  +  +  +  +--+--+  +  +
|  |  |        |  |     |     |  |  |     |        |  |        |  |  |  |  |  |     |  |  |
+  +  +--+--+--+  +  +  +--+  +  +  +--+--+--+--+--+  +  +--+  +  +  +  +  +  +  +  +  +  +
|  |           |     |  |     |  |     |        |     |     |  |  |  |  |  |  |  |  |  |  |
+  +--+--+  +  +  +--+  +  +--+  +--+  +  +--+  +  +--+--+  +  +  +--+  +  +  +  +  +  +--+
|        |  |     |     |  |     |     |  |     |        |  |  |     |  |  |  |  |  |     |
+--+--+  +--+--+--+  +--+  +  +--+  +--+  +  +--+--+--+  +  +--+--+  +  +  +--+  +  +--+  +
|  |     |     |     |     |  |     |     |     |        |           |  |        |        |
+  +  +--+  +  +  +--+  +--+  +  +--+  +--+--+  +  +--+--+  +--+--+--+  +--+--+--+--+--+  +
|  |     |  |  |  |     |     |        |     |     |  |     |           |           |     |
+  +--+  +  +  +  +  +--+--+  +--+--+--+  +--+--+--+  +  +--+  +  +--+  +--+--+--+  +  +--+
|     |     |  |  |  |     |        |                 |  |     |     |  |        |     |  |
+  +--+--+--+  +  +  +  +  +--+--+--+  +--+--+  +--+  +  +  +--+--+  +--+  +--+  +  +--+  +
|        |  |     |     |  |           |     |     |  |  |     |  |           |  |     |  |
+--+  +  +  +--+  +--+--+  +  +--+--+--+  +  +--+  +  +  +--+  +  +--+--+--+--+  +--+  +  +
|     |        |  |  |     |     |        |  |  |  |  |     |           |  |     |  |  |  |
+  +  +--+--+--+  +  +  +--+--+  +  +--+--+  +  +  +--+--+  +  +--+--+  +  +  +--+  +  +  +
|  |  |        |     |     |     |     |        |           |  |     |     |  |        |  |
+  +--+  +--+  +  +--+--+  +  +--+  +  +--+--+  +--+--+--+--+--+  +  +--+--+  +  +--+--+  +
|     |     |  |  |        |  |     |     |     |                 |     |     |     |     |
+--+  +--+  +  +  +  +--+--+  +  +--+--+  +  +--+--+--+  +--+--+--+--+  +  +--+--+  +--+  +
|        |  |     |  |        |  |     |  |        |     |     |     |     |     |        |
+  +--+  +  +--+--+  +  +--+--+  +  +  +  +--+--+  +  +--+  +  +  +  +--+--+  +  +--+--+  +
|     |  |  |     |     |        |  |  |        |     |     |     |  |        |  |     |  |
+  +  +--+  +--+  +--+--+  +--+--+  +  +--+--+  +--+--+  +--+--+--+--+  +  +--+--+  +  +  +
|  |     |              |  |        |        |     |     |              |  |        |     |
+  +--+  +--+--+--+--+  +  +  +--+--+--+--+  +--+  +  +  +  +--+--+--+--+  +  +--+--+--+--+
|     |           |     |     |     |     |  |     |  |     |              |        |     |
+  +--+  +--+--+  +  +--+--+--+  +  +  +  +--+  +--+  +--+--+  +--+--+  +--+--+--+  +--+  +
|  |     |     |  |              |     |        |  |        |     |     |        |     |  |
+  +  +--+  +--+  +--+--+--+--+--+--+--+--+--+--+  +--+--+  +--+  +--+--+  +  +--+--+  +  +
|  |     |           |        |                 |        |  |  |           |     |     |  |
+  +--+  +--+--+--+--+  +  +  +--+--+  +--+  +  +  +--+--+  +  +--+--+--+--+--+  +  +--+  +
|  |     |              |  |        |  |     |  |        |  |                 |     |     |
+  +  +--+  +--+--+--+--+  +--+--+  +--+  +--+  +--+--+  +  +--+--+--+  +--+  +--+--+  +  +
|  |        |           |     |           |           |  |           |     |  |        |  |
+  +--+--+--+--+--+--+  +--+  +--+--+--+  +--+--+--+  +  +--+--+--+  +--+  +  +  +  +--+  +
|  |     |                 |           |  |     |        |        |     |  |  |  |  |     |
+  +  +  +  +--+--+--+--+--+--+--+--+  +  +  +  +--+--+--+  +  +  +--+  +  +  +--+  +  +--+
|     |  |              |           |  |  |  |           |  |  |     |  |  |     |  |     |
+--+--+  +  +--+--+--+  +  +--+--+  +  +--+  +--+--+--+  +  +  +--+--+  +  +--+  +  +--+--+
|        |     |     |     |        |        |        |     |        |     |     |        |
+  +--+--+--+  +--+  +--+--+  +--+--+--+--+--+--+  +--+--+  +--+--+  +--+--+  +--+--+--+  +
|  |                    |  |  |           |        |     |  |  |           |              |
+  +  +--+--+--+--+--+  +  +  +  +  +--+  +  +--+  +  +  +  +  +  +  +--+--+--+--+--+--+  +
|  |        |        |     |  |  |     |     |     |  |  |     |  |  |              |     |
+  +--+  +--+  +--+  +--+  +  +  +--+  +--+--+  +--+  +  +--+  +  +--+  +--+--+  +  +  +--+
|  |     |     |     |     |  |  |  |     |     |     |  |     |  |           |  |  |     |
+  +--+  +  +--+  +--+--+  +  +  +  +--+  +--+--+  +--+  +--+--+  +  +--+--+--+  +  +--+  +
|     |  |     |        |  |           |        |  |              |     |        |     |  |
+--+  +  +--+  +--+--+  +  +--+--+--+  +--+--+  +  +--+--+--+--+  +--+  +  +--+--+--+--+  +
|     |  |     |     |  |     |     |        |  |        |           |  |                 |
+  +--+--+  +--+  +  +  +--+--+  +  +--+--+--+  +--+--+  +  +--+--+--+  +--+--+--+--+--+--+
|           |     |     |     |  |        |        |     |     |     |  |        |        |
+--+--+--+--+  +--+--+--+  +  +  +--+--+  +  +--+  +  +--+--+  +  +  +  +  +--+  +  +--+  +
|     |        |           |  |  |  |     |  |     |        |  |  |  |  |     |     |     |
+  +  +  +--+--+--+--+--+  +  +  +  +  +--+  +  +--+--+--+  +--+  +  +  +--+--+--+--+  +  +
|  |                       |     |           |           |        |                    |  |
+--+--+--+--+--+--+--+--+--+--+--+--+--+--+--+--+--+--+--+--+E-+--+--+--+--+--+--+--+--+--+
