+--+--+--+--+--+--+-S+--+--+--+--+--+--+--+--+--+--+--+--+--+--+--+--+--+--+--+--+--+--+--+
|              |     |           |        |                       |              |        |
+--+--+  +--+--+  +--+--+--+--+  +  +--+  +  +--+--+--+--+  +--+  +  +--+  +--+  +--+  +  +
|        |     |  |              |  |  |              |     |     |  |     |     |     |  |
+  +--+--+  +  +  +  +--+--+--+--+  +  +--+--+--+--+--+  +--+  +--+--+  +--+  +--+  +--+  +
|  |        |     |                    |  |              |  |           |     |        |  |
+  +  +--+--+--+--+--+--+--+--+--+--+  +  +  +--+--+--+--+  +--+--+--+--+  +--+  +--+  +  +
|  |     |                       |     |  |        |                    |  |     |     |  |
+  +--+  +--+--+--+  +--+--+--+  +  +--+  +--+--+  +  +--+--+--+--+--+  +  +--+--+  +--+  +
|     |     |        |  |        |        |        |              |     |        |     |  |
+--+  +--+  +  +--+--+  +  +--+--+--+  +--+  +--+--+  +--+--+--+  +--+  +--+--+  +  +  +  +
|        |  |     |     |     |     |  |     |        |        |     |        |  |  |  |  |
+  +--+  +  +--+  +  +--+--+  +  +--+  +  +--+  +--+--+  +--+  +--+  +--+--+--+  +--+  +  +
|     |  |  |     |     |     |        |     |        |  |        |           |  |     |  |
+  +  +--+  +  +--+--+  +  +--+--+--+--+--+  +--+--+  +  +  +--+  +--+--+--+  +  +  +--+--+
|  |        |  |     |                       |        |  |     |     |     |     |  |     |
+  +--+--+--+  +  +  +--+--+--+--+--+--+--+--+  +--+--+--+  +  +--+--+  +  +--+--+  +  +  +
|  |     |        |     |           |        |     |     |  |           |              |  |
+  +  +  +--+--+--+--+  +  +  +--+  +--+--+  +--+  +  +  +--+--+--+--+  +--+--+--+--+--+  +
|     |                 |  |  |  |              |     |              |           |  |     |
+--+--+--+--+--+--+--+--+--+  +  +--+--+--+--+  +--+--+--+--+--+--+  +--+--+--+  +  +  +--+
|        |                    |              |     |           |     |  |     |     |     |
+  +--+  +--+  +--+--+  +--+--+  +--+--+--+--+--+  +  +--+--+--+  +--+  +  +  +--+  +--+  +
|  |        |  |     |        |                    |  |           |        |     |     |  |
+  +--+--+  +  +  +  +--+--+  +  +--+--+--+--+--+  +  +  +--+--+--+  +--+--+--+  +--+  +  +
|        |  |  |  |           |        |        |     |        |  |        |     |     |  |
+--+--+  +  +--+  +--+--+--+--+--+--+  +  +--+  +--+--+--+--+  +  +--+--+  +  +--+  +--+  +
|        |        |                 |  |     |                 |           |  |        |  |
+  +--+--+--+--+--+  +--+--+--+--+  +  +--+  +--+--+--+--+--+--+--+--+  +--+  +  +--+--+  +
|           |     |           |     |     |  |                       |     |     |        |
+  +--+--+  +--+  +  +--+--+  +--+--+--+  +  +--+--+--+--+--+  +--+  +--+--+--+--+  +--+--+
|  |        |     |        |              |           |        |     |           |        |
+  +  +--+--+  +  +--+--+  +--+--+--+--+--+--+--+--+  +  +--+--+  +--+  +--+--+  +--+--+  +
|  |  |  |     |  |        |                 |        |  |        |        |              |
+  +  +  +  +  +--+  +--+--+--+--+--+--+--+  +  +--+--+  +  +--+--+--+--+  +--+--+--+--+  +
|  |  |     |        |                    |  |  |     |  |  |           |  |        |     |
+--+  +  +--+--+--+  +--+--+  +--+--+--+  +  +  +  +  +  +  +  +--+--+  +  +  +--+  +  +--+
|     |  |        |        |           |     |     |     |  |  |  |     |     |     |  |  |
+  +--+--+  +--+  +--+--+  +--+--+--+  +--+  +--+--+--+--+  +  +  +  +--+--+--+  +--+  +  +
|              |        |              |  |  |           |     |  |              |  |     |
+  +--+--+--+--+--+--+  +--+--+--+--+--+  +  +  +--+  +--+--+--+  +--+--+--+--+--+  +--+  +
|           |           |                 |  |     |                 |                 |  |
+--+--+  +--+  +--+--+--+  +--+--+--+--+  +  +--+--+--+--+--+--+--+  +  +  +--+--+--+--+  +
|     |  |     |     |     |           |  |           |              |  |  |              |
+  +  +--+  +--+  +--+  +--+--+--+--+  +  +--+--+--+  +  +--+--+--+  +  +  +  +--+--+--+--+
|  |        |                          |              |        |     |  |     |           |
+  +--+--+--+--+--+--+--+--+--+--+--+--+--+--+--+--+  +--+--+  +--+--+  +--+--+  +--+--+  +
|  |           |     |                             |        |  |        |        |        |
+  +  +--+--+  +  +  +  +--+--+--+--+--+--+--+--+  +--+--+  +  +  +--+--+--+  +--+  +--+--+
|  |  |     |     |  |  |                 |     |  |           |     |        |           |
+  +  +  +--+--+--+  +  +  +  +--+--+  +--+  +  +  +--+--+--+--+--+  +--+  +--+--+--+--+  +
|     |           |     |  |        |  |     |  |                 |     |        |        |
+  +--+--+--+--+  +--+--+--+  +--+  +--+  +--+  +--+--+--+--+--+  +--+  +--+--+  +  +--+--+
|           |              |     |        |        |  |           |  |           |        |
+--+--+--+  +  +--+--+--+  +--+  +--+--+--+  +--+  +  +  +--+--+  +  +--+--+--+--+--+--+  +
|        |     |     |     |  |        |     |        |  |                 |  |        |  |
+  +  +--+--+--+--+  +  +--+  +--+--+  +  +--+--+--+--+  +--+  +--+--+--+  +  +  +--+  +  +
|  |        |        |  |              |              |     |     |     |     |     |     |
+  +--+--+  +  +  +--+  +--+--+--+--+--+--+--+--+--+  +--+  +--+--+  +  +--+--+--+  +--+--+
|        |     |                                         |           |                    |
+--+--+--+--+--+--+--+  +--+--+--+--+--+--+--+--+--+--+--+--+--+--+--+--+--+--+--+--+--+--+
