+--+--+--+--+--+--+--+--+--+--+--+-S+--+--+--+--+--+--+--+--+
|              |                 |  |                       |
+  +--+--+  +  +--+  +--+--+--+  +  +--+--+--+--+  +--+--+  +
|        |  |     |  |  |        |                 |     |  |
+--+--+--+  +--+  +  +  +  +--+--+--+--+--+--+--+--+  +--+  +
|           |     |     |           |           |           |
+  +--+--+--+  +--+  +--+--+--+  +  +--+--+--+  +  +--+--+--+
|     |        |     |           |           |  |     |     |
+  +  +  +--+--+--+--+  +--+--+--+--+--+--+  +  +--+  +  +  +
|  |  |              |     |        |              |     |  |
+  +  +--+--+--+--+  +--+  +  +--+  +--+--+--+--+--+--+--+  +
|  |              |     |  |  |  |           |              |
+  +--+--+--+--+  +--+  +  +  +  +--+--+--+  +  +--+--+--+--+
|           |  |  |     |        |           |     |     |  |
+--+--+--+  +  +  +  +--+--+--+--+  +--+--+--+--+  +  +  +  +
|     |     |  |  |              |              |     |     |
+--+  +  +--+  +  +--+--+--+--+  +--+--+--+  +  +--+--+--+  +
|     |  |     |  |                    |     |  |        |  |
+  +--+  +  +--+  +  +--+--+--+--+--+  +  +--+--+  +  +--+  +
|  |     |     |  |     |        |        |     |  |        |
+  +  +--+--+  +  +--+--+  +--+  +--+--+--+  +  +  +--+--+--+
|  |           |  |           |  |           |     |        |
+  +--+--+--+  +  +  +--+--+--+  +  +--+--+--+--+--+  +  +--+
|           |  |  |  |           |  |                 |     |
+--+--+  +  +  +  +  +  +--+--+--+  +--+--+  +--+--+--+--+  +
|        |  |  |     |           |        |              |  |
+  +--+--+--+  +--+--+--+--+--+  +--+--+  +  +--+--+--+--+  +
|  |        |           |     |  |        |  |              |
+  +  +--+  +--+--+  +--+  +  +  +  +--+--+--+  +--+--+--+  +
|     |  |     |     |     |     |              |        |  |
+  +--+  +--+  +  +--+  +--+--+--+--+--+--+--+--+  +--+--+  +
|        |     |  |  |           |     |                    |
+  +--+--+  +  +  +  +--+--+--+  +  +  +  +--+--+--+--+--+--+
|  |        |  |           |  |     |     |                 |
+--+  +--+--+  +--+--+--+  +  +--+--+--+--+  +--+--+--+--+  +
|     |                 |  |              |           |     |
+  +--+--+--+--+--+--+--+  +  +--+--+--+  +--+--+--+  +  +--+
|                       |     |        |  |        |  |     |
+  +--+--+--+--+--+--+  +--+--+  +  +--+  +  +--+  +  +--+  +
|                    |           |           |        |     |
+--+--+--+--+--+--+--+--+--+  +--+--+--+--+--+--+--+--+--+--+
