+--+--+-S+--+--+--+--+--+--+--+--+--+--+--+--+--+--+--+--+--+--+--+--+--+--+--+--+--+--+--+
|  |     |                       |                             |     |                    |
+  +  +--+  +--+--+--+--+  +--+  +--+  +--+--+--+--+--+--+--+  +  +--+  +--+--+  +--+--+  +
|  |     |  |              |  |        |                    |  |     |  |        |     |  |
+  +--+  +  +  +--+--+--+--+  +--+--+--+  +--+--+--+  +--+--+  +  +  +  +  +--+--+  +--+  +
|     |  |  |  |                       |           |  |     |  |  |     |     |  |     |  |
+  +--+  +  +  +  +--+--+  +--+--+--+--+--+--+--+  +  +  +  +  +  +--+--+--+  +  +  +  +  +
|     |  |  |  |        |                       |  |     |     |  |           |     |  |  |
+--+  +  +  +  +--+--+  +--+--+--+--+--+  +--+  +  +--+--+--+--+--+  +--+--+--+  +--+  +  +
|     |  |  |  |        |              |  |     |     |              |        |     |     |
+  +--+  +  +  +--+  +--+--+  +--+--+  +  +  +--+--+  +--+  +--+--+--+--+--+  +--+  +--+--+
|        |  |     |           |        |  |        |        |              |     |        |
+  +--+--+--+--+  +--+--+--+--+  +--+--+  +--+--+--+--+--+--+  +--+--+--+  +  +  +--+--+  +
|     |           |           |        |                             |  |     |  |     |  |
+--+  +  +  +--+--+  +--+--+  +--+--+--+--+  +--+--+--+--+--+--+--+  +  +--+--+  +  +  +  +
|  |  |  |           |     |              |              |     |     |           |  |     |
+  +  +--+--+--+--+--+  +  +  +--+--+  +  +--+--+--+--+  +  +--+  +--+--+--+--+  +  +--+--+
|  |                    |  |  |     |  |           |        |     |           |  |  |     |
+  +--+--+--+--+--+--+--+  +  +  +  +  +--+--+--+  +--+--+--+  +--+  +--+--+  +--+  +--+  +
|           |        |  |  |  |  |  |     |        |           |        |     |     |     |
+--+  +--+  +--+  +  +  +  +--+  +  +--+--+  +--+--+  +  +--+--+  +--+--+  +  +  +--+  +  +
|     |     |     |     |        |     |     |        |  |        |  |     |  |        |  |
+  +--+  +--+  +--+--+--+--+--+--+--+  +  +--+  +--+--+--+  +--+--+  +  +--+--+--+--+--+  +
|  |           |                    |     |                          |              |     |
+  +--+--+--+  +  +--+--+--+--+--+  +--+--+--+--+--+--+--+--+--+--+--+--+--+--+--+  +  +--+
|  |        |  |     |     |                       |           |                    |  |  |
+  +  +--+  +  +--+  +  +--+  +--+--+--+--+--+--+  +  +--+--+  +  +--+--+--+--+--+--+  +  +
|  |  |  |  |  |     |     |     |        |        |  |        |           |           |  |
+  +  +  +  +--+  +--+--+  +--+  +--+  +--+  +--+--+  +  +--+--+--+--+--+  +  +--+--+--+  +
|  |     |                    |     |        |        |                 |  |           |  |
+  +--+  +--+--+--+--+  +--+--+--+  +  +--+--+--+--+  +--+--+  +--+--+  +  +--+--+--+  +  +
|           |     |     |           |                 |        |     |              |     |
+  +--+--+--+  +  +  +--+  +--+--+--+--+--+--+--+--+  +--+--+--+  +  +--+--+--+--+--+--+  +
|        |     |  |     |  |     |              |     |           |                    |  |
+--+--+  +  +--+  +--+--+  +  +--+  +--+--+  +--+  +--+  +--+--+--+--+--+--+--+--+--+  +  +
|  |     |     |           |        |     |           |        |                 |  |     |
+  +  +--+--+  +--+--+--+  +--+--+--+  +  +--+--+--+--+--+--+  +--+--+  +--+--+  +  +--+--+
|  |        |        |     |           |                    |  |        |  |     |        |
+  +  +--+--+--+--+  +--+--+  +--+--+--+--+--+--+--+  +--+--+  +  +--+--+  +  +--+  +--+--+
|  |  |              |        |                    |           |  |     |     |           |
+  +  +  +--+--+--+  +  +--+--+--+--+--+  +--+--+--+--+--+--+--+  +  +  +  +--+  +--+--+  +
|  |  |     |     |  |  |                 |                       |  |     |           |  |
+  +  +--+  +--+  +  +  +  +  +--+--+--+--+  +--+--+--+--+--+  +--+  +--+--+--+  +--+--+  +
|     |  |     |     |  |  |                                |     |           |  |        |
+  +--+  +--+  +  +--+  +  +--+--+--+--+--+--+--+--+--+--+  +--+  +--+--+--+  +--+  +--+  +
|  |        |  |     |  |  |                             |     |     |     |     |  |     |
+  +--+  +--+  +  +--+  +  +  +--+--+--+--+--+--+--+--+  +--+--+--+  +  +--+--+  +  +--+  +
|     |     |  |  |     |  |  |     |                 |              |  |        |     |  |
+--+  +--+  +  +--+  +--+--+  +  +  +  +--+--+--+--+  +--+--+--+--+--+  +  +--+--+  +  +--+
|  |        |     |     |     |  |  |           |  |              |     |  |        |     |
+  +--+--+  +--+  +--+  +  +--+  +--+--+--+--+  +  +--+--+--+  +  +  +  +  +--+--+  +--+  +
|     |  |     |        |     |           |     |     |        |  |  |     |     |     |  |
+  +  +  +--+  +--+--+--+--+  +--+  +--+  +  +--+--+  +  +--+--+--+  +--+--+  +  +--+  +  +
|  |     |  |              |     |  |     |  |        |              |        |     |  |  |
+  +--+  +  +--+--+--+--+  +--+  +  +  +--+  +  +--+  +--+--+--+--+--+  +--+--+--+  +  +  +
|     |     |           |  |     |  |     |  |     |        |           |     |     |  |  |
+  +  +--+  +  +--+  +  +  +  +--+  +--+--+  +--+  +--+--+  +--+  +--+--+--+  +  +--+--+  +
|  |     |  |     |  |  |     |     |        |     |     |        |           |  |        |
+  +--+  +--+--+  +  +--+--+--+  +--+  +--+--+  +--+  +--+--+--+--+  +--+--+--+  +  +--+  +
|     |           |                             |                                   |     |
+--+--+--+E-+--+--+--+--+--+--+--+--+--+--+--+--+--+--+--+--+--+--+--+--+--+--+--+--+--+--+
