+--+--+--+--+--+--+--+--+--+--+--+--+--+--+--+--+  +--+--+--+--+--+--+--+--+--+--+--+--+--+
|                       |  |           |           |     |           |           |        |
+  +--+  +--+--+--+--+  +  +  +--+--+  +  +--+--+--+  +--+  +  +--+  +--+  +--+  +  +  +--+
|     |        |     |     |  |     |     |                 |     |     |     |     |     |
+--+  +--+--+  +  +  +--+  +  +--+  +--+--+--+--+  +--+--+--+--+  +--+  +  +--+--+--+--+  +
|     |        |  |     |  |        |           |     |           |     |  |              |
+  +--+  +--+--+  +--+  +  +--+--+  +  +--+  +  +--+--+  +--+--+--+  +--+--+  +--+--+--+  +
|  |     |     |     |  |        |  |  |     |     |     |     |     |        |        |  |
+--+  +--+  +--+  +  +  +--+--+  +  +--+  +--+--+  +  +--+  +  +  +--+  +--+--+  +--+  +  +
|     |  |        |  |  |        |        |        |        |  |        |           |  |  |
+  +--+  +  +--+--+  +--+  +--+--+--+--+--+  +--+--+--+--+--+  +--+--+--+  +--+--+  +--+  +
|     |           |           |              |                 |        |  |     |        |
+--+  +--+--+--+--+--+--+--+  +  +--+--+--+--+--+  +--+--+--+--+  +--+  +  +--+  +--+--+--+
|     |     |           |     |  |        |        |              |  |  |                 |
+  +--+  +  +  +--+--+  +--+  +  +--+--+  +  +  +--+--+--+--+  +--+  +  +--+--+--+--+--+  +
|  |     |           |     |  |        |     |              |     |  |        |        |  |
+  +  +--+--+--+--+--+--+  +  +--+--+  +--+--+--+  +--+--+  +--+  +  +  +--+--+  +--+  +  +
|  |     |     |     |     |        |           |  |     |  |  |     |           |     |  |
+  +  +--+  +  +  +  +  +--+--+--+--+--+--+--+  +  +  +--+  +  +--+  +--+--+--+--+  +--+  +
|     |     |     |     |                       |     |     |     |     |        |        |
+  +--+  +--+--+--+--+--+  +--+--+--+--+--+--+--+--+--+  +--+--+  +--+  +  +  +--+--+--+--+
|     |  |                 |     |     |                 |           |  |  |              |
+--+--+  +  +--+--+--+--+--+  +--+  +  +  +--+  +--+--+--+  +  +--+--+  +--+--+--+  +--+  +
|        |           |  |           |     |  |        |  |  |  |     |     |     |     |  |
+  +--+--+--+--+--+  +  +  +--+--+--+--+--+  +--+--+  +  +  +  +  +  +--+  +  +  +  +  +  +
|  |                 |  |           |              |  |     |     |     |     |  |  |  |  |
+  +  +--+--+--+--+--+  +--+--+--+  +--+--+--+--+  +  +--+  +--+--+  +--+--+--+  +--+  +--+
|     |                                            |     |        |  |        |     |     |
+  +--+--+--+--+--+  +--+--+--+--+--+--+--+--+--+  +--+  +--+--+  +  +  +--+  +--+  +--+  +
|                 |           |                 |     |     |     |  |     |        |     |
+--+--+--+--+--+  +--+--+--+--+  +--+--+--+--+  +  +--+--+  +  +--+  +--+  +--+--+--+  +  +
|     |           |              |        |     |  |        |  |        |     |        |  |
+  +  +  +--+--+--+  +--+--+--+--+  +--+  +  +--+--+  +--+--+  +  +--+  +--+  +--+  +--+  +
|  |     |        |     |              |  |           |  |     |     |     |  |     |     |
+  +--+--+--+  +  +--+  +  +--+--+--+  +--+--+--+--+--+  +  +--+--+  +--+--+  +  +--+--+--+
|     |     |  |  |     |  |     |     |                 |        |           |           |
+--+  +  +  +  +  +  +--+--+  +  +  +--+  +--+--+  +--+  +--+--+  +--+--+--+--+--+--+--+  +
|     |  |     |  |           |  |        |        |     |     |                          |
+  +--+  +--+--+  +--+--+  +--+  +--+--+  +  +--+--+  +--+  +  +--+--+--+--+--+--+--+--+  +
|  |     |     |        |     |        |  |  |     |        |     |        |     |        |
+  +  +--+  +  +--+--+  +--+  +--+--+  +  +  +--+  +--+--+--+--+  +--+  +  +--+  +  +--+--+
|     |     |           |     |        |  |     |                       |  |     |        |
+--+--+  +--+--+--+--+--+  +--+  +--+--+--+--+  +--+--+--+--+--+--+--+--+  +  +  +--+--+  +
|        |        |     |     |           |     |           |        |        |  |     |  |
+  +--+--+  +--+  +  +  +--+  +--+--+--+  +  +--+  +--+--+  +  +--+  +--+--+--+  +  +--+  +
|           |  |  |  |        |        |  |        |        |     |           |     |     |
+--+--+--+--+  +  +--+--+  +--+  +--+  +  +--+--+--+  +--+  +--+  +--+--+--+  +--+--+  +--+
|  |           |  |     |        |  |  |  |     |     |     |     |        |           |  |
+  +  +--+--+  +  +  +  +--+--+--+  +  +  +  +  +  +--+--+--+  +--+  +--+--+--+--+--+--+  +
|        |     |     |        |        |     |  |              |  |                    |  |
+  +--+--+  +--+--+--+--+--+  +  +--+--+--+--+  +  +--+--+--+--+  +  +--+--+  +--+--+  +  +
|  |     |        |           |  |        |     |        |                 |     |  |     |
+--+  +  +--+  +--+  +--+--+--+  +  +--+--+  +--+--+--+  +--+  +--+--+--+--+--+  +  +--+  +
|     |        |     |           |        |           |     |  |  |              |  |     |
+  +--+--+--+--+  +--+--+--+--+  +--+--+  +--+--+--+  +--+  +  +  +  +--+--+--+--+  +  +--+
|  |     |     |              |                 |     |     |     |  |        |     |  |  |
+  +  +  +  +  +--+--+--+--+  +  +--+--+--+--+  +  +--+  +--+--+--+  +  +--+--+  +  +  +  +
|     |  |  |     |           |  |        |     |  |  |              |           |     |  |
+  +--+  +  +  +--+  +--+--+--+--+  +--+  +--+--+  +  +--+--+--+--+--+  +--+--+--+--+--+  +
|     |     |                       |              |                                      |
+--+--+--+--+--+--+--+--+--+--+--+--+--+--+--+--+--+  +--+--+--+--+--+--+--+--+--+--+--+--+
