+--+--+--+--+--+--+--+--+--+--+-S+--+--+--+--+--+--+--+--+--+
|        |                 |     |     |                    |
+  +--+--+  +--+  +--+--+--+  +--+  +  +  +--+  +--+--+--+  +
|           |  |           |     |  |  |  |  |     |        |
+  +--+--+--+  +--+--+--+  +--+  +  +--+  +  +--+  +  +--+--+
|  |           |           |     |           |     |        |
+  +--+  +--+--+  +--+--+--+  +--+--+--+--+  +  +--+--+--+--+
|  |     |        |        |              |  |              |
+  +  +--+  +  +--+  +--+  +--+--+--+--+  +  +--+--+--+--+  +
|  |     |  |  |        |        |     |  |  |  |           |
+  +  +  +  +--+  +--+--+  +--+  +--+  +  +  +  +  +--+--+  +
|  |  |  |        |        |           |  |  |  |        |  |
+  +--+  +--+--+--+  +  +--+--+--+--+--+  +  +  +--+--+  +--+
|     |  |           |  |     |           |     |     |     |
+--+  +  +  +--+--+--+--+  +  +  +--+--+--+--+  +  +--+--+  +
|        |        |        |     |        |        |     |  |
+--+--+--+--+--+  +  +--+--+--+--+--+--+  +  +--+--+  +  +  +
|                 |        |           |     |        |     |
+  +--+--+--+--+--+--+--+  +  +--+--+  +  +--+  +--+--+--+  +
|  |                    |     |        |     |           |  |
+  +  +--+--+--+--+  +--+--+--+  +--+--+--+  +--+--+--+  +--+
|  |  |           |  |        |     |     |           |     |
+  +  +--+  +--+--+  +  +  +--+--+  +--+  +--+--+--+  +--+  +
|  |  |     |        |  |           |        |           |  |
+  +  +  +--+  +--+--+  +--+--+--+--+  +--+--+  +--+--+--+  +
|     |     |           |           |                 |     |
+  +--+--+  +--+--+--+--+  +--+--+--+  +--+--+--+--+  +  +--+
|        |                             |     |     |  |     |
+--+--+  +  +--+--+--+--+  +--+--+--+--+  +  +  +  +--+--+  +
|     |  |  |           |           |     |     |     |     |
+  +  +  +--+  +--+--+  +--+--+--+--+  +--+--+--+--+  +  +  +
|  |  |        |     |              |        |           |  |
+  +  +--+--+--+  +--+--+--+--+--+  +--+--+  +--+  +--+--+--+
|  |  |                          |  |     |     |  |        |
+  +--+  +--+--+--+  +--+--+--+  +  +  +  +  +  +--+  +--+  +
|  |              |        |     |     |  |  |           |  |
+  +  +--+--+--+--+--+--+  +--+--+--+--+  +--+--+--+--+--+  +
|     |  |                 |           |  |           |     |
+  +--+  +  +--+--+--+--+--+  +--+  +--+  +  +--+--+  +  +  +
|        |                       |           |           |  |
+--+--+--+--+--+--+--+--+--+--+--+--+--+E+--+--+--+--+--+--+
