+--+--+--+--+--+--+--+--+--+--+--+--+--+--+--+--+--+--+--+--+-S+--+--+--+--+--+--+--+--+--+
|        |                             |  |                    |                          |
+  +--+--+  +--+  +--+--+--+--+--+--+  +  +  +--+--+--+--+--+--+--+--+  +--+--+--+--+--+  +
|           |  |           |        |  |  |     |                       |           |     |
+  +--+--+--+  +--+--+--+  +  +--+--+  +  +--+  +--+  +--+  +--+--+--+--+  +--+--+--+  +--+
|     |              |     |           |     |     |     |     |                 |     |  |
+--+  +--+  +--+--+  +  +--+  +--+--+--+--+  +--+  +--+  +--+  +  +--+--+--+--+  +  +--+  +
|  |     |  |     |  |     |                    |     |  |     |  |     |        |        |
+  +--+  +--+  +  +  +--+  +--+--+--+--+--+--+--+--+  +--+  +--+  +--+  +  +--+--+--+--+  +
|              |     |     |        |        |        |     |           |           |     |
+  +--+--+--+--+--+  +  +--+  +--+  +  +--+  +  +--+--+  +--+--+--+--+  +--+--+--+  +  +--+
|        |     |     |           |     |     |        |              |           |  |  |  |
+--+--+  +  +  +--+--+--+--+--+--+--+--+  +--+--+--+  +--+--+--+--+  +--+--+--+--+  +  +  +
|  |     |  |  |                          |        |                 |              |     |
+  +  +--+  +  +  +--+--+--+--+--+--+--+  +  +  +--+--+--+--+--+--+--+  +--+--+--+--+--+  +
|        |  |     |     |                 |  |                          |           |     |
+--+--+--+  +--+--+--+  +  +--+--+--+--+--+  +--+--+--+--+--+--+--+--+  +  +--+--+  +  +--+
|           |           |     |     |        |        |              |  |     |  |     |  |
+  +--+--+--+  +--+  +--+--+  +--+  +  +--+--+--+  +--+  +--+--+--+  +  +--+  +  +--+--+  +
|           |     |  |        |     |  |        |  |     |              |     |     |     |
+--+--+--+  +--+  +--+  +--+--+  +--+  +  +--+  +  +  +--+  +--+--+--+--+  +--+  +--+  +  +
|           |     |              |     |     |     |     |  |              |           |  |
+  +--+--+--+  +--+  +--+--+--+--+  +--+--+  +--+--+--+  +--+  +--+--+--+--+--+--+--+--+  +
|     |     |        |              |     |           |        |              |           |
+--+  +  +--+  +--+--+  +--+--+--+--+  +  +--+  +--+  +--+--+--+  +--+--+--+  +  +--+--+  +
|     |           |  |           |     |     |  |              |  |     |        |        |
+  +--+--+--+--+  +  +--+--+--+  +  +--+--+  +--+  +--+--+--+  +  +  +  +--+--+--+  +--+--+
|              |              |     |     |        |  |        |     |     |     |  |     |
+--+--+--+--+  +--+--+--+--+  +--+--+  +--+--+--+--+  +  +--+--+--+--+--+  +  +--+  +--+  +
|           |        |     |     |                       |                 |     |        |
+  +--+--+  +--+--+  +--+  +--+  +  +--+--+--+--+--+--+--+--+--+  +--+--+--+  +  +--+--+  +
|     |           |     |        |  |              |              |        |  |           |
+  +  +--+--+--+  +--+  +  +--+--+  +--+  +--+--+  +--+  +--+--+--+  +  +--+  +--+--+--+--+
|  |     |              |  |     |        |     |     |        |     |        |           |
+--+--+  +--+--+--+--+--+  +  +--+--+--+--+--+  +--+  +--+--+  +  +--+--+--+--+--+  +--+  +
|        |     |           |                       |           |     |              |     |
+  +--+--+  +  +  +--+--+--+--+--+  +--+--+--+--+  +--+--+--+--+--+  +  +--+--+--+--+  +--+
|           |  |     |           |  |           |           |     |     |              |  |
+  +--+--+--+  +--+  +--+  +--+  +  +  +--+  +--+--+--+--+  +--+  +--+--+  +--+--+--+--+  +
|     |        |  |     |  |  |     |  |     |                    |        |              |
+  +--+  +--+--+  +--+  +  +  +--+--+  +--+--+  +--+--+--+--+--+--+  +--+--+--+  +--+--+  +
|  |     |              |  |                 |  |     |              |           |        |
+  +  +--+--+  +--+--+--+  +--+--+--+--+--+  +  +--+  +  +--+--+--+--+  +--+--+--+  +--+--+
|  |        |              |              |     |     |  |              |           |     |
+  +--+--+  +  +--+--+--+--+  +--+--+--+  +  +--+  +  +  +  +--+--+--+--+  +--+--+--+  +--+
|        |  |  |              |           |        |  |     |           |  |              |
+--+--+  +  +--+  +--+--+--+--+  +--+--+--+  +--+--+--+--+--+  +--+--+  +  +  +--+--+--+  +
|        |     |           |  |        |     |                 |     |  |  |           |  |
+--+--+--+--+  +--+--+--+  +  +--+--+  +--+--+  +--+  +--+--+--+--+  +  +  +--+--+--+--+  +
|              |        |  |     |     |        |  |     |        |     |        |        |
+  +--+--+--+  +  +--+--+  +  +  +  +--+  +--+--+  +--+  +  +--+  +--+--+--+--+  +  +--+  +
|     |     |  |  |        |  |  |     |     |        |     |     |              |  |     |
+  +  +  +--+  +  +  +--+--+  +  +--+  +--+  +  +--+--+--+--+  +--+  +--+--+--+--+  +--+--+
|  |  |           |           |     |        |              |     |  |  |                 |
+--+  +--+--+--+--+--+--+--+--+--+  +--+--+--+  +--+  +--+  +--+  +  +  +  +--+--+--+--+  +
|     |                          |        |        |     |  |  |     |  |           |     |
+  +--+  +--+--+  +--+--+--+--+--+--+--+  +--+  +--+--+  +  +  +--+--+  +  +--+--+--+  +--+
|     |        |                       |     |  |     |  |     |     |     |        |     |
+  +  +--+--+  +--+--+--+--+--+--+  +--+--+  +--+  +  +  +--+  +  +  +--+--+  +--+  +--+  +
|  |                             |                 |     |        |           |           |
+--+--+--+--+--+--+--+--+--+E-+--+--+--+--+--+--+--+--+--+--+--+--+--+--+--+--+--+--+--+--+
